50
10,10,10,10,10,10,10,10,10,15
11,11,11,11,11,11,11,11,11,10
10,14,10,10,10,11,10,10,10,10
10,11,11,11,10,11,10,11,11,11
10,10,10,11,10,10,10,11,13,10
6,11,10,10,10,11,11,11,10,10
