30
10,10,10,10,11,10,10,11,10,10
10,11,10,10,11,10,10,11,10,10
6,11,10,10,11,10,10,11,10,10
10,11,10,10,10,10,10,10,10,10
10,10,10,11,11,11,10,10,11,10
10,10,10,10,10,11,10,15,11,10