35
6,10,11,10,11,10,10,11,10,10
10,10,10,10,11,10,14,11,10,10
10,11,10,11,10,10,10,10,10,11
10,10,10,10,10,11,10,11,10,10
11,10,11,10,13,10,10,10,10,10
10,10,10,11,10,10,10,11,10,15
