50
6,11,10,10,11,10,10,11,10,10
10,11,10,11,10,10,11,10,10,11
10,10,10,10,10,11,10,10,11,10
11,10,11,10,11,10,10,10,10,14
10,10,10,10,10,10,11,10,13,11
10,11,10,11,10,10,10,10,10,15
