25
6,10,11,10,11,10,10,11,10,10
10,11,10,10,11,10,11,10,10,11
10,10,10,11,10,10,10,11,10,10
11,10,10,10,10,11,10,10,10,11
10,10,11,10,10,10,10,11,10,10
10,11,10,10,10,11,10,10,10,5
