40
6,10,11,10,11,10,13,11,10,10
10,11,10,10,11,10,10,11,10,11
10,10,10,11,10,10,10,10,10,10
11,10,11,10,10,11,10,11,14,10
10,10,10,10,11,10,10,10,10,11
10,11,10,10,10,10,11,10,10,15
